111111111111111111
1P000E000000000001
10000000100000C001
10000C000000000001
111111111111111111
100000000000100001
111111111111111111