11111111111111111111
1P0000001111111C0011
101111101C0000101001
1000011C111110101001
11110111111000001001
100000001C00101C1001
11111010111110111001
100C000000C000000011
101111110111111110C1
100C000000C000000011
11110111111110101001
100000000C00000C1001
11110111110111111001
100000000C0000000001
1C1C111111111C10E1C1
11111111111111111111