1111111111111111111
1P0000C000000100011
1000000010000010001
1000C00000010000001
1010000001000000001
1000000001000C00001
1011111111111111001
1000000000000001001
1001110000000000001
100000000000000C001
1111111000000000011
1000000000000000001
1011000000000000001
1000000010000000001
1111111111111111111